11111111111111111111111111111111111111111111111111
12001000000000000000000100000000000000000000000001
10001000000000000000000100000000000000000000000001
10001000000000000000000100000000000000000000000001
11011110111100000000000100000000000000000000000001
10000000000000000000000100000000000000000000000001
10000000000000000000000100000000000000000000000001
10110110000000000000000100000000000000000000000001
10000010000000000000000100000000000000000000000001
11101110000000000000000100000000000000000000000001
10000000000000000001111100000000000000000000000001
10000000000000000000000000000000000000000000000001
10000000000000000000000000000000000000000000000001
10000000000000000000000000000000000000000000000001
10000000000000000001111100000000000000000000000001
10000000000000000000000100000000000000000000000001
10000000000000000000000100000000000000000000000001
10000000000000000000000100000000000000000000000001
10000000000000000000000100000000000000000000000001
10000000000000000000000100000000000000000000000001
10000000000000000000000100000000000000000000000001
10000000000000000000000100000000000000000000000001
10000000000000000000000100000000000000000000000001
10000000000000000000000100000000000000000000000001
10000000000000000000000100000000000000000000000001
10000000000000000000000100000000000000000000000001
10000000000000000000000100000000000000000000000001
10000000000000000000000100000000000000000000000001
10000000000000000000000100000000000000000000000001
10000000000000000000000100000000000000000000000001
10000000000000000000000100000000000000000000000001
10000000000000000000000100000000000000000000000001
10000000000000000000000100000000000000000000000001
10000000000000000000000100000000000000000000000001
10000000000000000000000100000000000000000000000001
10000000000000000000000100000000000000000000000001
10000000000000000000000100000000000000000000000001
10000000000000000000000100000000000000000000000001
10000000000000000000000100000000000000000000000001
10000000000000000000000100000000000000000000000001
10000000000000000000000100000000000000000000000001
10000000000000000000000100000000000000000000000001
10000000000000000000000100000000000000000000000001
10000000000000000000000100000000000000000000000001
10000000000000000000000100000000000000000000000001
10000000000000000000000100000000000000000000000001
10000000000000000000000100000000000000000000000001
10000000000000000000000100000000000000000000000001
10400000000000000000000100000000000000000000000031
11111111111111111111111111111111111111111111111111