11111111111111111111111111111111111111111111111111
10000000000110000000000000000000000000000000010001
10000002000110000000000000000000000000000000010301
10000000000110000000000000000000000000000600010001
10000000000110011001100110000000000000000000010001
10001111111110011001100111100000000000000000010001
10000000000110005555000111111000000000700000010001
10000000000111105115011110001110000000000000010001
10000000000111105115011110000011100000000000010001
11111111000110005555000110000000111000000000010001
10000000000110011001100110000000001110000000010001
10000000000110011001100110001110000011100000010001
10000000000110000000000110001111000000111000010001
10001111111111100110011110001111100000011000010001
10000000000111100110011110001114111000000000010001
10000000000115555500000110001100001100000000010001
15555555000110011001100110001100001111111111110001
11111111000110011001100110000000000000000000010001
10000000000110000000000110000005000000000000010001
10000000000111100110011110000005000000000000010001
10005555555111100110011111111111111111111500010001
10001111111110000000000111111111111111115000010001
10000000000110011551100111111111111111150000010001
10000000000110011551100111111111111111500000510001
15555555000110000000000111111111111115000005110001
11111111000111100110011111111111111150000051110001
10000000000111100110011111111111111500000511110001
10000550000110000000000111111111115000005111110001
10000000000115511001100111111111150000051111110001
10001111111115511001100111111111500000511111110001
10000000000110000000000111111115000005111111110001
10000550000111100110011111111150000051111111110001
10000000000111100110011111111500000511111111110001
11111111000110000005555111115000005111111111110001
15550000000110011001100111150000051111111111110001
15000000000110011001100111500000511111111111110001
15000000000110000000000115000005111111111111110001
10001111111111155110011110000000000000550000010001
10000000555111155110011110000000000000110000010001
10000000005110000000000110001011100000011000010001
10000000005110011001100110010011100000001100010001
11111111000110011001100110001011100000000100010001
10000000000110000000000110000000001100000100010001
10060000000111100110011110000000001100000100010001
10000000000111100110011110001011100000000100010001
10001111111110000000000110010011155555551100010001
10000000000000011001100110001011100000011000010001
10000000700000011001100110000000000000110000000701
10000000000000000000000110000000000000000000000001
11111111111111111111111111111111111111111111111111