11111111111111111111111111111111111111111111111111
10000000555000000000000000000000000000000000000001
10200000000000000050000000005500000005500050000051
10000000000000005550000000000000000000000050000001
10001111111111111111111000011111111111111111111111
15001060550000000000055000000000000000000000010001
15001005500555000000000000055500000000055555510001
15001000000005000000000000000500000000000000510551
15051111111111111111111111111111111111111100510001
10051000100000000000000000000000000000000100010001
10051000106000000055500000055500000000000100015501
10051000100005550000000050000550000055500100010001
10001000111111111111111050011111111111500150015551
10001000100000000000000050000000000051500150015551
15501550105550000005555555555550000051000150010001
10501000105550000000000000000000000051000100010001
10501050105511111111111111111111110051550100010001
10001050100010001000000000000050010001000100010501
10001055100015551055550000000050010001000100010501
10051005100010001000000000000000010001050105510501
10051005100015551005111100111100010001050100510501
10051005105010001005150000055100015501050100510001
10001005100010001005154555555100510001050100010501
10000000100010000000111111111100510001000100000501
15555505150015555555550000000000510001000100005501
10000000100010000000000000000000510001000100005501
10001000100010000000111111111100515501000100055501
10501050100015051000100000555100510001000100010001
10501000100015051500165500006100010001000100010001
10501000105015051500111100111100010001055100010001
15501000100015051500005500000500010001000100010001
10001000100015051500000555000500010001000100515001
10001055100015051555000000000000015501550100515001
10051000105015051111111111111111110001500100515001
10051000100000000555555506555555500001500100515001
10001550100050000005555500555550000001000100010001
10001000100050000000000000000000000001000100010001
10001000111111111111111111111111111111000100010001
15501000150055000000000000000000000000000500015501
10001000156000000000555000500005555555555500010001
10001050150055000000000000500000000000000000010551
15051050111111111111111111111111111111111111110001
10001050000000065500000055000000000000055000010001
10001055555555555500000000000000000055005506010001
10001000000000000000000500000000000005500000010001
10001111111111111111111500011111111111111111115501
10000000000000055000000000005550000000000000015501
15555555000000055000000000000000055555500000015301
10000000000000055000000055000000000000000000010001
11111111111111111111111111111111111111111111111111